xxxxxxxxxxxxxxxxxexxxxx
x_____________________x
x___1_________________x
x________x____________x
x________x____________x
x________x____________x
x______1_________2____x
x________p____________x
x_____________________x
x_____________________x
x_____________2_______x
x________x____________x
x_____________________x
x__________1__________x
xxxxxxxxxxxxxxxxxxxxxxx