xxxxxxxxxexxxx
x____________x
x___1________x
x____________x
x____________x
x____________x
x____________x
x________p___x
x____________x
x____________x
x____________x
xxxxxxxxxxxxxx