xxxxxxxxxxxxxxexxx
x________________x
x___1____________x
x________x_______x
x________x_______x
x________x_______x
x____________2___x
x________p_______x
x________________x
x___1____________x
x________________x
x________________x
xxxxxxxxxxxxxxxxxx